...........
.............
.....###
....##.#.####
...##..###..#
..##........#
..#...@..#..#
..###..###..#
....#..#....#
...##.##.#.##
...#......##
...#.....##
...#######
#############
#############