..............................
..............................
..............................
....wwwwwwwwwwwwwwwwwwwwww....
....w...........D*WXXXXXXw....
....w.......Q..E.*XXXXXXXw....
....w.........L.f*XXXXXXXw....
....wY@.........K*XXXXXXXw....
....w........E.Q.*XXXXXXXw....
....w..........L.*XXXXXXXw....
....w.......D....P.......w....
....wwwwwwwwwwwwwwwwwwwwww....
..............................
..............................
..............................