.
.
..#########..
..#...#.#.#
..#.#.#.#.#
..#.###.#.#
..#.......#
..#.#.#####
..#.#.#...#
..#@#.....#
..#########
.
.