{||||||||}
'........"
'........"
's.....s."
'S.....S."
's.....s."
'S...@.S."
[////Z///]